Date,MMWR_week,Location,Date Type,Short Name,Long Name,Percent of Total Pop with at least One Dose,Percent of Total Pop Fully Vaccinated,Percent of Total Fully Vaccinated Pop with a First Booster Dose,Administered,Total Doses Administered Daily,Daily Count People Receiving Dose 1,Total Doses Administered Cumulative,People Receiving 1 or More Doses Cumulative,7-Day Avg Daily Count Dose 1,7-Day Avg Total Doses Daily,Daily Count of People Fully Vaccinated,People Fully Vaccinated Cumulative,7-Day Avg Daily Count of People Fully Vaccinated,Daily Count People Receiving a First Booster Dose,People Receiving a First Booster Dose Cumulative,7-Day Average Daily Count First Booster
12/14/2020,N/A,US,Admin,USA,United States,0,0,0,36743,4599,4438,36743,31061,15531,18372,128,6666,3333,0,0,0
12/15/2020,N/A,US,Admin,USA,United States,0,0,0,84742,47999,45835,84742,76896,25632,28247,265,6931,2310,0,0,0
12/16/2020,N/A,US,Admin,USA,United States,0.1,0,0,244164,159422,154204,244164,231100,57775,61041,453,7384,1846,0,0,0
12/17/2020,N/A,US,Admin,USA,United States,0.1,0,0,516885,272721,265823,516885,496923,99385,103377,759,8143,1629,0,0,0
12/18/2020,N/A,US,Admin,USA,United States,0.3,0,0,933557,416672,408220,933557,905143,150857,155593,1211,9354,1559,0,0,0
12/19/2020,N/A,US,Admin,USA,United States,0.3,0,0,1115685,182128,178248,1115685,1083391,154770,159384,1074,10428,1490,0,0,0
12/20/2020,N/A,US,Admin,USA,United States,0.4,0,0,1221307,105622,103649,1221307,1187040,165774,169880,727,11155,660,0,0,0
12/21/2020,N/A,US,Admin,USA,United States,0.5,0,0,1603854,382547,375797,1603854,1562837,218825,223873,1515,12670,858,0,0,0
12/22/2020,N/A,US,Admin,USA,United States,0.6,0,0,2052329,448475,439797,2052329,2002634,275105,281084,2965,15635,1243,0,0,0
12/23/2020,N/A,US,Admin,USA,United States,0.8,0,0,2627181,574852,563292,2627181,2565926,333547,340431,3081,18716,1619,0,0,0
12/24/2020,N/A,US,Admin,USA,United States,0.8,0,0,2823303,196122,191284,2823303,2757210,322898,329488,1112,19828,1669,0,0,0
12/25/2020,N/A,US,Admin,USA,United States,0.8,0,0,2836031,12728,12565,2836031,2769775,266376,271782,107,19935,1512,0,0,0
12/26/2020,N/A,US,Admin,USA,United States,0.9,0,0,2977633,141602,138373,2977633,2908148,260680,265993,962,20897,1496,0,0,0
12/27/2020,N/A,US,Admin,USA,United States,0.9,0,0,3073995,96362,93671,3073995,3001819,259254,264670,735,21632,1497,0,0,0
12/28/2020,N/A,US,Admin,USA,United States,1.1,0,0,3665537,591542,577510,3665537,3579329,288070,294526,4270,25902,1890,0,0,0
12/29/2020,N/A,US,Admin,USA,United States,1.3,0,0,4387607,722070,703932,4387607,4283261,325804,333611,5267,31169,2219,0,0,0
12/30/2020,N/A,US,Admin,USA,United States,1.5,0,0,5231094,843487,824902,5231094,5108163,363177,371988,7838,39007,2899,0,0,0
12/31/2020,N/A,US,Admin,USA,United States,1.7,0,0,5652041,420947,411638,5652041,5519801,394656,404105,3205,42212,3198,0,0,0
1/1/2021,N/A,US,Admin,USA,United States,1.7,0,0,5760361,108320,98017,5760361,5617818,406863,417761,7221,49433,4214,0,0,0
1/2/2021,N/A,US,Admin,USA,United States,1.8,0,0,6024494,264133,256172,6024494,5873990,423692,435266,2889,52322,4489,0,0,0
1/3/2021,N/A,US,Admin,USA,United States,1.8,0,0,6163664,139170,132277,6163664,6006267,429207,441381,2466,54788,4737,0,0,0
1/4/2021,N/A,US,Admin,USA,United States,2,0,0,6821617,657953,600384,6821617,6606651,432475,450869,44947,99735,10548,0,0,0
1/5/2021,N/A,US,Admin,USA,United States,2.2,0.1,0,7653495,831878,731990,7653495,7338641,436483,466555,87597,187332,22309,0,0,0
1/6/2021,N/A,US,Admin,USA,United States,2.5,0.1,0,8676903,1023408,832401,8676903,8171042,437554,492258,172712,360044,45862,1,1,0
1/7/2021,N/A,US,Admin,USA,United States,2.7,0.2,0,9847710,1170807,867775,9847710,9038817,502717,599381,281329,641373,85594,1,2,0
1/8/2021,N/A,US,Admin,USA,United States,3,0.3,0,11084833,1237123,849137,11084833,9887954,610019,760639,363907,1005280,136550,0,2,0
1/9/2021,N/A,US,Admin,USA,United States,3.1,0.3,0,11593645,508812,370966,11593645,10258920,626419,795593,128876,1134156,154548,1,3,0
1/10/2021,N/A,US,Admin,USA,United States,3.1,0.4,0,11845347,251702,176743,11845347,10435663,632771,811669,69736,1203892,164158,0,3,0
1/11/2021,N/A,US,Admin,USA,United States,3.4,0.5,0,12916367,1071020,725013,12916367,11160676,650575,870679,323057,1526949,203888,0,3,0
1/12/2021,N/A,US,Admin,USA,United States,3.6,0.6,0,14175940,1259573,918510,14175940,12079186,677221,931778,314915,1841864,236362,2,5,1
1/13/2021,N/A,US,Admin,USA,United States,3.9,0.6,0,15500655,1324715,1031315,15500655,13110501,705637,974822,270939,2112803,250394,1,6,1
1/14/2021,N/A,US,Admin,USA,United States,4.3,0.7,0,16817528,1316873,1158465,16817528,14268966,747164,995688,136056,2248859,229641,0,6,1
1/15/2021,N/A,US,Admin,USA,United States,4.6,0.7,0,18075713,1258185,1118168,18075713,15387134,785597,998697,121098,2369957,194954,1,7,1
1/16/2021,N/A,US,Admin,USA,United States,4.8,0.7,0,18726245,650532,567724,18726245,15954858,813705,1018943,72078,2442035,186840,1,8,1
1/17/2021,N/A,US,Admin,USA,United States,4.9,0.7,0,19032428,306183,256563,19032428,16211421,825108,1026726,42212,2484247,182908,0,8,1
1/18/2021,N/A,US,Admin,USA,United States,5.1,0.8,0,19918728,886300,639503,19918728,16850924,812893,1000337,228332,2712579,169376,3,11,1
1/19/2021,N/A,US,Admin,USA,United States,5.4,0.9,0,21266018,1347290,966731,21266018,17817655,819781,1012868,357209,3069788,175418,0,11,1
1/20/2021,N/A,US,Admin,USA,United States,5.7,1.1,0,22872141,1606123,1155890,22872141,18973545,837578,1053069,421918,3491706,196986,4,15,1
1/21/2021,N/A,US,Admin,USA,United States,6.1,1.1,0,24506598,1634457,1332660,24506598,20306205,862463,1098439,275589,3767295,216919,4,19,2
1/22/2021,N/A,US,Admin,USA,United States,6.5,1.2,0,26136550,1629952,1394603,26136550,21700808,901953,1151548,210156,3977451,229642,2,21,2
1/23/2021,N/A,US,Admin,USA,United States,6.8,1.2,0,27046091,909541,744615,27046091,22445423,927224,1188549,151217,4128668,240948,2,23,2
1/24/2021,N/A,US,Admin,USA,United States,6.9,1.3,0,27442458,396367,300695,27442458,22746118,933528,1201433,88561,4217229,247569,2,25,2
1/25/2021,N/A,US,Admin,USA,United States,7.1,1.4,0,28817709,1375251,861166,28817709,23607284,965194,1271283,490443,4707672,285013,3,28,2
1/26/2021,N/A,US,Admin,USA,United States,7.4,1.6,0,30482134,1664425,1054133,30482134,24661417,977680,1316588,583402,5291074,317327,2,30,3
1/27/2021,N/A,US,Admin,USA,United States,7.8,1.8,0,32418083,1935949,1252847,32418083,25914264,991531,1363706,649932,5941006,349900,5,35,3
1/28/2021,N/A,US,Admin,USA,United States,8.2,2,0,34383338,1965255,1372060,34383338,27286324,997160,1410963,559577,6500583,390470,10,45,4
1/29/2021,N/A,US,Admin,USA,United States,8.6,2.1,0,36300935,1917597,1374485,36300935,28660809,994286,1452055,497385,6997968,431502,6,51,4
1/30/2021,N/A,US,Admin,USA,United States,8.9,2.2,0,37320999,1020064,759375,37320999,29420184,996394,1467844,243147,7241115,444635,4,55,5
1/31/2021,N/A,US,Admin,USA,United States,9,2.2,0,37781546,460547,322634,37781546,29742818,999529,1477013,127623,7368738,450216,6,61,5
2/1/2021,N/A,US,Admin,USA,United States,9.2,2.4,0,39172472,1390926,772989,39172472,30515807,986932,1479252,575743,7944481,462401,6,67,6
2/2/2021,N/A,US,Admin,USA,United States,9.5,2.6,0,40872075,1699603,964453,40872075,31480260,974120,1484277,701150,8645631,479222,5,72,6
2/3/2021,N/A,US,Admin,USA,United States,9.9,2.9,0,43014577,2142502,1261899,43014577,32742159,975414,1513785,836249,9481880,505839,5,77,6
2/4/2021,N/A,US,Admin,USA,United States,10.3,3.1,0,45364151,2349574,1390035,45364151,34132194,977981,1568688,914785,10396665,556583,12,89,6
2/5/2021,N/A,US,Admin,USA,United States,10.7,3.4,0,47723161,2359010,1356608,47723161,35488802,975428,1631747,962701,11359366,623057,6,95,6
2/6/2021,N/A,US,Admin,USA,United States,10.9,3.5,0,49026841,1303680,853873,49026841,36342675,988927,1672263,422853,11782219,648729,7,102,7
2/7/2021,N/A,US,Admin,USA,United States,11,3.6,0,49472246,445405,277553,49472246,36620228,982487,1670100,157225,11939444,652958,5,107,7
2/8/2021,N/A,US,Admin,USA,United States,11.3,3.8,0,51054750,1582504,838357,51054750,37458585,991825,1697468,706741,12646185,671672,6,113,7
2/9/2021,N/A,US,Admin,USA,United States,11.6,4.1,0,53031793,1977043,1038078,53031793,38496663,1002343,1737103,897369,13543554,699703,10,123,7
2/10/2021,N/A,US,Admin,USA,United States,12,4.4,0,55340450,2308657,1230239,55340450,39726902,997820,1760839,1037956,14581510,728519,12,135,8
2/11/2021,N/A,US,Admin,USA,United States,12.4,4.7,0,57750779,2410329,1277962,57750779,41004864,981810,1769518,1091506,15673016,753764,9,144,8
2/12/2021,N/A,US,Admin,USA,United States,12.8,5.1,0,60339386,2588607,1379887,60339386,42384751,985136,1802318,1159204,16832220,781836,17,161,9
2/13/2021,N/A,US,Admin,USA,United States,13,5.2,0,61817211,1477825,870679,61817211,43255430,987536,1827196,573165,17405385,803309,14,175,10
2/14/2021,N/A,US,Admin,USA,United States,13.1,5.3,0,62410711,593500,346878,62410711,43602308,997440,1848352,229590,17634975,813647,10,185,11
2/15/2021,N/A,US,Admin,USA,United States,13.3,5.5,0,63591065,1180354,610681,63591065,44212989,964915,1790902,535876,18170851,789238,6,191,11
2/16/2021,N/A,US,Admin,USA,United States,13.6,5.7,0,65214649,1623584,797421,65214649,45010410,930535,1740408,788888,18959739,773741,2,193,10
2/17/2021,N/A,US,Admin,USA,United States,13.8,6,0,67182842,1968193,933753,67182842,45944163,888180,1691770,991884,19951623,767159,5,198,9
2/18/2021,N/A,US,Admin,USA,United States,14.1,6.3,0,69043028,1860186,834409,69043028,46778572,824815,1613178,976485,20928108,750727,10,208,9
2/19/2021,N/A,US,Admin,USA,United States,14.3,6.6,0,71012918,1969890,824403,71012918,47602975,745461,1524790,1097272,22025380,741880,13,221,9
2/20/2021,N/A,US,Admin,USA,United States,14.5,6.8,0,72320645,1307727,597204,72320645,48200179,706393,1500491,681035,22706415,757290,14,235,9
2/21/2021,N/A,US,Admin,USA,United States,14.6,6.9,0,72917665,597020,254674,72917665,48454853,693221,1500993,324050,23030465,770784,12,247,9
2/22/2021,N/A,US,Admin,USA,United States,14.8,7.2,0,74381845,1464180,617914,74381845,49072767,694254,1541540,803205,23833670,808974,20,267,11
2/23/2021,N/A,US,Admin,USA,United States,15,7.5,0,76323573,1941728,867471,76323573,49940238,704261,1586989,1027899,24861569,843119,29,296,15
2/24/2021,N/A,US,Admin,USA,United States,15.4,7.9,0,78855604,2532031,1246433,78855604,51186671,748930,1667537,1235884,26097453,877976,28,324,18
2/25/2021,N/A,US,Admin,USA,United States,15.9,8.3,0,81798544,2942940,1538204,81798544,52724875,849472,1822217,1343785,27441238,930447,34,358,21
2/26/2021,N/A,US,Admin,USA,United States,16.4,8.7,0,84917666,3119122,1674298,84917666,54399173,970885,1986393,1384824,28826062,971526,60,418,28
2/27/2021,N/A,US,Admin,USA,United States,16.7,8.9,0,86916440,1998774,1141869,86916440,55541042,1048695,2085114,818582,29644644,991176,28,446,30
2/28/2021,N/A,US,Admin,USA,United States,16.9,9,0,87773599,857159,535363,87773599,56076405,1088793,2122276,295618,29940262,987114,25,471,32
3/1/2021,N/A,US,Admin,USA,United States,17.3,9.3,0,89833877,2060278,1203725,89833877,57280130,1172480,2207433,797056,30737318,986235,25,496,33
3/2/2021,N/A,US,Admin,USA,United States,17.7,9.5,0,92301804,2467927,1465324,92301804,58745454,1257888,2282604,961985,31699303,976819,35,531,34
3/3/2021,N/A,US,Admin,USA,United States,18.2,9.9,0,95210399,2908595,1744480,95210399,60489934,1329038,2336399,1124626,32823929,960925,37,568,35
3/4/2021,N/A,US,Admin,USA,United States,18.8,10.3,0,98418540,3208141,1958518,98418540,62448452,1389082,2374285,1245365,34069294,946865,41,609,36
3/5/2021,N/A,US,Admin,USA,United States,19.4,10.7,0,101652510,3233970,2005743,101652510,64454195,1436432,2390692,1308479,35377773,935959,32,641,32
3/6/2021,N/A,US,Admin,USA,United States,19.8,10.9,0,103714612,2062102,1352038,103714612,65806233,1466456,2399739,863652,36241425,942397,17,658,30
3/7/2021,N/A,US,Admin,USA,United States,20,11,0,104640998,926386,678097,104640998,66484330,1486846,2409628,343822,36585247,949284,3,661,27
3/8/2021,N/A,US,Admin,USA,United States,20.5,11.3,0,106809458,2168460,1484433,106809458,67968763,1526948,2425083,852483,37437730,957202,17,678,26
3/9/2021,N/A,US,Admin,USA,United States,21,11.6,0,109521429,2711971,1811858,109521429,69780621,1576452,2459946,1082158,38519888,974369,21,699,24
3/10/2021,N/A,US,Admin,USA,United States,21.6,12,0,112651133,3129704,2065486,112651133,71846107,1622310,2491533,1270165,39790053,995161,26,725,22
3/11/2021,N/A,US,Admin,USA,United States,22.3,12.4,0,116096318,3445185,2279854,116096318,74125961,1668216,2525397,1401538,41191591,1017471,27,752,20
3/12/2021,N/A,US,Admin,USA,United States,23,12.9,0,119528653,3432335,2119925,119528653,76245886,1684527,2553735,1530398,42721989,1049174,35,787,21
3/13/2021,N/A,US,Admin,USA,United States,23.4,13.2,0,121723004,2194351,1386141,121723004,77632027,1689399,2572627,1019566,43741555,1071447,21,808,21
3/14/2021,N/A,US,Admin,USA,United States,23.6,13.3,0,122708151,985147,648829,122708151,78280856,1685218,2581022,427067,44168622,1083339,12,820,23
3/15/2021,N/A,US,Admin,USA,United States,24,13.6,0,124994365,2286214,1499836,124994365,79780692,1687418,2597844,870508,45039130,1085914,40,860,26
3/16/2021,N/A,US,Admin,USA,United States,24.6,13.9,0,127886616,2892251,1932555,127886616,81713247,1704661,2623598,1050025,46089155,1081324,32,892,28
3/17/2021,N/A,US,Admin,USA,United States,25.3,14.2,0,131060161,3173545,2130215,131060161,83843462,1713908,2629861,1131981,47221136,1061583,47,939,31
3/18/2021,N/A,US,Admin,USA,United States,25.9,14.6,0,134468064,3407903,2298582,134468064,86142044,1716583,2624535,1206323,48427459,1033695,43,982,33
3/19/2021,N/A,US,Admin,USA,United States,26.6,15,0,137811384,3343320,2216661,137811384,88358705,1730403,2611819,1224701,49652160,990024,50,1032,35
3/20/2021,N/A,US,Admin,USA,United States,27,15.2,0,139970801,2159417,1413237,139970801,89771942,1734274,2606828,860918,50513078,967360,55,1087,40
3/21/2021,N/A,US,Admin,USA,United States,27.2,15.3,0,140992891,1022090,684657,140992891,90456599,1739392,2612106,372082,50885160,959505,43,1130,44
3/22/2021,N/A,US,Admin,USA,United States,27.7,15.6,0,143361712,2368821,1606315,143361712,92062914,1754603,2623907,808571,51693731,950657,78,1208,50
3/23/2021,N/A,US,Admin,USA,United States,28.3,15.9,0,146432773,3071061,1986013,146432773,94048927,1762240,2649451,1154132,52847863,965530,93,1301,58
3/24/2021,N/A,US,Admin,USA,United States,29,16.3,0,149997105,3564332,2212162,149997105,96261089,1773947,2705278,1424921,54272784,1007378,111,1412,68
3/25/2021,N/A,US,Admin,USA,United States,29.7,16.8,0,153840285,3843180,2270134,153840285,98531223,1769883,2767460,1650631,55923415,1070851,97,1509,75
3/26/2021,N/A,US,Admin,USA,United States,30.3,17.4,0,157676969,3836684,2107185,157676969,100638408,1754243,2837941,1802979,57726394,1153462,100,1609,82
3/27/2021,N/A,US,Admin,USA,United States,30.7,17.7,0,160154792,2477823,1373296,160154792,102011704,1748537,2883427,1165683,58892077,1197000,69,1678,84
3/28/2021,N/A,US,Admin,USA,United States,30.9,17.9,0,161367304,1212512,672889,161367304,102684593,1746856,2910630,551641,59443718,1222651,56,1734,86
3/29/2021,N/A,US,Admin,USA,United States,31.4,18.3,0,164211635,2844331,1610975,164211635,104295568,1747522,2978560,1276475,60720193,1289495,118,1852,92
3/30/2021,N/A,US,Admin,USA,United States,32,18.8,0,167812181,3600546,2017153,167812181,106312721,1751971,3054201,1663996,62384189,1362332,153,2005,101
3/31/2021,N/A,US,Admin,USA,United States,32.7,19.4,0,171991298,4179117,2415834,171991298,108728555,1781067,3142028,1942214,64326403,1436231,160,2165,108
4/1/2021,N/A,US,Admin,USA,United States,33.5,20.1,0,176559806,4568508,2536090,176559806,111264645,1819060,3245646,2245805,66572208,1521256,228,2393,126
4/2/2021,N/A,US,Admin,USA,United States,34.1,20.6,0,180223216,3663410,2062475,180223216,113327120,1812673,3220892,1818641,68390849,1523494,101,2494,126
4/3/2021,N/A,US,Admin,USA,United States,34.5,20.9,0,182529204,2305988,1327409,182529204,114654529,1806118,3196345,1160336,69551185,1522730,76,2570,127
4/4/2021,N/A,US,Admin,USA,United States,34.7,21.1,0,183294260,765056,438614,183294260,115093143,1772650,3132422,371967,69923152,1497062,25,2595,123
4/5/2021,N/A,US,Admin,USA,United States,35.2,21.5,0,186405797,3111537,1738023,186405797,116831166,1790800,3170595,1604035,71527187,1543856,102,2697,121
4/6/2021,N/A,US,Admin,USA,United States,35.9,22.2,0,190391622,3985825,2293063,190391622,119124229,1830215,3225634,2082845,73610032,1603692,125,2822,117
4/7/2021,N/A,US,Admin,USA,United States,36.7,22.9,0,194755647,4364025,2565305,194755647,121689534,1851568,3252050,2307083,75917115,1655816,120,2942,111
4/8/2021,N/A,US,Admin,USA,United States,37.4,23.6,0,199263773,4508126,2571196,199263773,124260730,1856584,3243424,2518814,78435929,1694817,142,3084,99
4/9/2021,N/A,US,Admin,USA,United States,38.2,24.4,0,203589511,4325738,2443887,203589511,126704617,1911071,3338042,2440734,80876663,1783688,126,3210,102
4/10/2021,N/A,US,Admin,USA,United States,38.7,24.9,0,206482294,2892783,1727524,206482294,128432141,1968230,3421870,1658695,82535358,1854882,90,3300,104
4/11/2021,N/A,US,Admin,USA,United States,38.9,25.1,0,207884767,1402473,834535,207884767,129266676,2024790,3512930,801787,83337145,1916285,40,3340,106
4/12/2021,N/A,US,Admin,USA,United States,39.4,25.6,0,210906647,3021880,1634602,210906647,130901278,2010016,3500121,1726846,85063991,1933829,100,3440,106
4/13/2021,N/A,US,Admin,USA,United States,40,26.1,0,214386759,3480112,1742322,214386759,132643600,1931339,3427877,1720318,86784309,1882040,87,3527,101
4/14/2021,N/A,US,Admin,USA,United States,40.5,26.7,0,218080693,3693934,1729315,218080693,134372915,1811912,3332149,1928277,88712586,1827924,142,3669,104
4/15/2021,N/A,US,Admin,USA,United States,41,27.3,0,221825865,3745172,1752602,221825865,136125517,1694970,3223156,1952601,90665187,1747037,137,3806,103
4/16/2021,N/A,US,Admin,USA,United States,41.5,27.9,0,225426837,3600972,1633806,225426837,137759323,1579244,3119618,1931193,92596380,1674245,128,3934,103
4/17/2021,N/A,US,Admin,USA,United States,41.8,28.2,0,227788755,2361918,1163246,227788755,138922569,1498633,3043780,1178503,93774883,1605646,72,4006,101
4/18/2021,N/A,US,Admin,USA,United States,42,28.4,0,228921874,1133119,538283,228921874,139460852,1456311,3005301,583502,94358385,1574463,32,4038,100
4/19/2021,N/A,US,Admin,USA,United States,42.3,28.9,0,231501211,2579337,1083177,231501211,140544029,1377536,2942081,1466527,95824912,1537274,92,4130,99
4/20/2021,N/A,US,Admin,USA,United States,42.7,29.4,0,234727770,3226559,1357512,234727770,141901541,1322563,2905859,1837084,97661996,1553955,142,4272,106
4/21/2021,N/A,US,Admin,USA,United States,43.2,30,0,238197374,3469604,1379855,238197374,143281396,1272640,2873812,2052784,99714780,1571742,159,4431,109
4/22/2021,N/A,US,Admin,USA,United States,43.6,30.7,0,241689467,3492093,1398127,241689467,144679523,1222001,2837657,2059418,101774198,1587002,173,4604,114
4/23/2021,N/A,US,Admin,USA,United States,44,31.2,0,244980201,3290734,1351219,244980201,146030742,1181631,2793338,1907774,103681972,1583656,114,4718,112
4/24/2021,N/A,US,Admin,USA,United States,44.3,31.6,0,247187777,2207576,1004266,247187777,147035008,1158920,2771289,1187904,104869876,1584999,81,4799,113
4/25/2021,N/A,US,Admin,USA,United States,44.4,31.7,0,248180390,992613,490065,248180390,147525073,1152032,2751217,496133,105366009,1572518,56,4855,117
4/26/2021,N/A,US,Admin,USA,United States,44.7,32.2,0,250566490,2386100,932387,250566490,148457460,1130490,2723611,1435349,106801358,1568064,130,4985,122
4/27/2021,N/A,US,Admin,USA,United States,45,32.7,0,253458790,2892300,1104941,253458790,149562401,1094409,2675860,1793867,108595225,1561890,127,5112,120
4/28/2021,N/A,US,Admin,USA,United States,45.4,33.3,0,256544396,3085606,1142413,256544396,150704814,1060488,2621003,1969859,110565084,1550043,153,5265,119
4/29/2021,N/A,US,Admin,USA,United States,45.7,33.9,0,259588374,3043978,1109437,259588374,151814251,1019247,2556987,1983584,112548668,1539210,151,5416,116
4/30/2021,N/A,US,Admin,USA,United States,46.1,34.5,0,262494752,2906378,1106279,262494752,152920530,984255,2502079,1855691,114404359,1531770,171,5587,124
5/1/2021,N/A,US,Admin,USA,United States,46.3,34.8,0,264342747,1847995,705964,264342747,153626494,941641,2450710,1168304,115572663,1528970,158,5745,135
5/2/2021,N/A,US,Admin,USA,United States,46.4,35,0,265221975,879228,325361,265221975,153951855,918112,2434512,586024,116158687,1541811,33,5778,132
5/3/2021,N/A,US,Admin,USA,United States,46.6,35.4,0,267183859,1961884,636255,267183859,154588110,875807,2373910,1403624,117562311,1537279,116,5894,130
5/4/2021,N/A,US,Admin,USA,United States,46.8,35.9,0,269681406,2497547,813628,269681406,155401738,834191,2317517,1758534,119320845,1532231,100,5994,126
5/5/2021,N/A,US,Admin,USA,United States,47.1,36.5,0,272228429,2547023,812850,272228429,156214588,787111,2240576,1809216,121130061,1509282,148,6142,125
5/6/2021,N/A,US,Admin,USA,United States,47.3,37,0,274747094,2518665,773989,274747094,156988577,739189,2165531,1820522,122950583,1485988,97,6239,118
5/7/2021,N/A,US,Admin,USA,United States,47.5,37.6,0,277253376,2506282,789182,277253376,157777759,693890,2108375,1792174,124742757,1476914,124,6363,111
5/8/2021,N/A,US,Admin,USA,United States,47.7,37.9,0,278788952,1535576,505648,278788952,158283407,665273,2063744,1089267,125832024,1465623,69,6432,98
5/9/2021,N/A,US,Admin,USA,United States,47.7,38,0,279404226,615274,204753,279404226,158488160,648044,2026036,438204,126270228,1444506,22,6454,97
5/10/2021,N/A,US,Admin,USA,United States,47.9,38.4,0,281008547,1604321,481857,281008547,158970017,625987,1974955,1176388,127446616,1412044,91,6545,93
5/11/2021,N/A,US,Admin,USA,United States,48.1,38.8,0,283055859,2047312,656490,283055859,159626507,603538,1910636,1453603,128900219,1368482,97,6642,93
5/12/2021,N/A,US,Admin,USA,United States,48.3,39.3,0,285070692,2014833,643754,285070692,160270261,579382,1834609,1439808,130340027,1315709,91,6733,84
5/13/2021,N/A,US,Admin,USA,United States,48.6,39.7,0,287347616,2276924,927021,287347616,161197282,601244,1800075,1409209,131749236,1256950,98,6831,85
5/14/2021,N/A,US,Admin,USA,United States,48.9,40.1,0,289799385,2451769,1091719,289799385,162289001,644463,1792287,1439355,133188591,1206548,92,6923,80
5/15/2021,N/A,US,Admin,USA,United States,49.2,40.4,0,291646646,1847261,908160,291646646,163197161,701965,1836813,992961,134181552,1192790,81,7004,82
5/16/2021,N/A,US,Admin,USA,United States,49.3,40.6,0,292580460,933814,477842,292580460,163675003,740978,1882319,487176,134668728,1199786,21,7025,82
5/17/2021,N/A,US,Admin,USA,United States,49.6,40.9,0,294402865,1822405,886623,294402865,164561626,798801,1913474,1012587,135681315,1176386,78,7103,80
5/18/2021,N/A,US,Admin,USA,United States,49.9,41.2,0,296475590,2072725,991057,296475590,165552683,846597,1917104,1166727,136848042,1135403,79,7182,77
5/19/2021,N/A,US,Admin,USA,United States,50.2,41.6,0,298563762,2088172,987571,298563762,166540254,895713,1927581,1181465,138029507,1098497,95,7277,78
5/20/2021,N/A,US,Admin,USA,United States,50.4,41.9,0,300584071,2020309,922988,300584071,167463242,895137,1890922,1178588,139208095,1065551,99,7376,78
5/21/2021,N/A,US,Admin,USA,United States,50.7,42.3,0,302642528,2058457,933102,302642528,168396344,872478,1834735,1205702,140413797,1032172,87,7463,77
5/22/2021,N/A,US,Admin,USA,United States,50.9,42.5,0,304092624,1450096,730834,304092624,169127178,847145,1777997,772790,141186587,1000719,77,7540,77
5/23/2021,N/A,US,Admin,USA,United States,51,42.6,0,304751156,658532,339123,304751156,169466301,827328,1738671,347376,141533963,980748,31,7571,78
5/24/2021,N/A,US,Admin,USA,United States,51.2,42.9,0,306071967,1320811,636288,306071967,170102589,791566,1667015,752385,142286348,943576,98,7669,81
5/25/2021,N/A,US,Admin,USA,United States,51.4,43.1,0,307509735,1437768,669084,307509735,170771673,745570,1576306,840205,143126553,896930,88,7757,82
5/26/2021,N/A,US,Admin,USA,United States,51.6,43.4,0,308943995,1434260,661714,308943995,171433387,699019,1482890,838982,143965535,848004,84,7841,81
5/27/2021,N/A,US,Admin,USA,United States,51.8,43.6,0,310290982,1346987,614712,310290982,172048099,654980,1386702,799274,144764809,793816,70,7911,76
5/28/2021,N/A,US,Admin,USA,United States,52,43.8,0,311620409,1329427,604746,311620409,172652845,608072,1282554,787389,145552198,734057,107,8018,79
5/29/2021,N/A,US,Admin,USA,United States,52.1,44,0,312386014,765605,381575,312386014,173034420,558177,1184770,421736,145973934,683907,46,8064,75
5/30/2021,N/A,US,Admin,USA,United States,52.2,44,0,312771347,385333,201324,312771347,173235744,538492,1145742,205334,146179268,663615,51,8115,78
5/31/2021,N/A,US,Admin,USA,United States,52.2,44.1,0,312973744,202397,89454,312973744,173325198,460373,985968,122369,146301637,573613,88,8203,76
6/1/2021,N/A,US,Admin,USA,United States,52.4,44.3,0,314242338,1268594,528352,314242338,173853550,440268,961800,784919,147086556,565715,157,8360,86
6/2/2021,N/A,US,Admin,USA,United States,52.5,44.5,0,315359844,1117506,495711,315359844,174349261,416553,916550,681412,147767968,543205,62,8422,83
6/3/2021,N/A,US,Admin,USA,United States,52.7,44.8,0,316607140,1247296,464219,316607140,174813480,395054,902308,838961,148606929,548874,57,8479,81
6/4/2021,N/A,US,Admin,USA,United States,52.8,45,0,318009779,1402639,501135,318009779,175314615,380253,912767,959617,149566546,573478,67,8546,75
6/5/2021,N/A,US,Admin,USA,United States,52.9,45.3,0,319081917,1072138,354505,319081917,175669120,376386,956558,752113,150318659,620675,39,8585,74
6/6/2021,N/A,US,Admin,USA,United States,53,45.4,0,319598852,516935,171655,319598852,175840775,372147,975358,363692,150682351,643298,22,8607,70
6/7/2021,N/A,US,Admin,USA,United States,53.1,45.6,0,320670418,1071566,373504,320670418,176214279,412726,1099525,740881,151423232,731656,58,8665,66
6/8/2021,N/A,US,Admin,USA,United States,53.2,45.9,0,321846415,1175997,404978,321846415,176619257,395101,1086297,819132,152242364,736544,55,8720,51
6/9/2021,N/A,US,Admin,USA,United States,53.3,46.1,0,323013401,1166986,392152,323013401,177011409,380307,1093365,823336,153065700,756819,60,8780,51
6/10/2021,N/A,US,Admin,USA,United States,53.4,46.3,0,324184710,1171309,405547,324184710,177416956,371925,1082510,817118,153882818,753698,58,8838,51
6/11/2021,N/A,US,Admin,USA,United States,53.6,46.6,0,325416620,1231910,428727,325416620,177845683,361581,1058120,854523,154737341,738685,58,8896,50
6/12/2021,N/A,US,Admin,USA,United States,53.7,46.8,0,326310504,893884,281270,326310504,178126953,351119,1032655,643316,155380657,723143,35,8931,49
6/13/2021,N/A,US,Admin,USA,United States,53.7,46.9,0,326703769,393265,113712,326703769,178240665,342841,1014988,296561,155677218,713552,15,8946,48
6/14/2021,N/A,US,Admin,USA,United States,53.8,47.1,0,327617218,913449,332660,327617218,178573325,337007,992400,620378,156297596,696338,45,8991,47
6/15/2021,N/A,US,Admin,USA,United States,53.9,47.3,0,328595748,978530,361422,328595748,178934747,330784,964190,661770,156959366,673857,92,9083,52
6/16/2021,N/A,US,Admin,USA,United States,54,47.5,0,329540825,945077,359127,329540825,179293874,326066,932489,631659,157591025,646475,48,9131,50
6/17/2021,N/A,US,Admin,USA,United States,54.1,47.6,0,330435431,894606,352262,330435431,179646136,318454,892960,591831,158182856,614291,36,9167,47
6/18/2021,N/A,US,Admin,USA,United States,54.2,47.8,0,331357234,921803,368996,331357234,180015132,309921,848659,597134,158779990,577521,36,9203,44
6/19/2021,N/A,US,Admin,USA,United States,54.3,47.9,0,331932923,575689,231720,331932923,180246852,302843,803203,370247,159150237,538511,29,9232,43
6/20/2021,N/A,US,Admin,USA,United States,54.3,48,0,332210121,277198,112594,332210121,180359446,302683,786622,176264,159326501,521326,39,9271,46
6/21/2021,N/A,US,Admin,USA,United States,54.4,48.1,0,332771668,561547,302358,332771668,180661804,298354,736350,293691,159620192,474657,26,9297,44
6/22/2021,N/A,US,Admin,USA,United States,54.5,48.2,0,333528199,756531,325318,333528199,180987122,293196,704636,469230,160089422,447151,54,9351,38
6/23/2021,N/A,US,Admin,USA,United States,54.6,48.4,0,334265091,736892,331700,334265091,181318822,289278,674895,442376,160531798,420110,44,9395,38
6/24/2021,N/A,US,Admin,USA,United States,54.7,48.5,0,334965420,700329,319922,334965420,181638744,284658,647141,417813,160949611,395251,28,9423,37
6/25/2021,N/A,US,Admin,USA,United States,54.8,48.6,0,335733198,767778,352353,335733198,181991097,282281,625138,452892,161402503,374645,41,9464,37
6/26/2021,N/A,US,Admin,USA,United States,54.9,48.7,0,336233026,499828,225923,336233026,182217020,281453,614300,295406,161697909,363953,26,9490,37
6/27/2021,N/A,US,Admin,USA,United States,54.9,48.7,0,336500782,267756,127426,336500782,182344446,283571,612952,150691,161848600,360300,21,9511,34
6/28/2021,N/A,US,Admin,USA,United States,55,48.8,0,337055568,554786,276687,337055568,182621133,279904,611986,305472,162154072,361983,35,9546,36
6/29/2021,N/A,US,Admin,USA,United States,55.1,48.9,0,337684453,628885,298949,337684453,182920082,276137,593751,358387,162512459,346148,61,9607,37
6/30/2021,N/A,US,Admin,USA,United States,55.2,49.1,0,338316755,632302,308741,338316755,183228823,272857,578809,351335,162863794,333142,75,9682,41
7/1/2021,N/A,US,Admin,USA,United States,55.3,49.2,0,338924414,607659,293758,338924414,183522581,269120,565571,334927,163198721,321301,99,9781,51
7/2/2021,N/A,US,Admin,USA,United States,55.4,49.3,0,339545241,620827,307005,339545241,183829586,262641,544578,341571,163540292,305398,34,9815,50
7/3/2021,N/A,US,Admin,USA,United States,55.4,49.3,0,339902788,357547,182072,339902788,184011658,256377,524252,188894,163729186,290182,22,9837,50
7/4/2021,N/A,US,Admin,USA,United States,55.4,49.3,0,339953170,50382,27809,339953170,184039467,242146,493198,27365,163756551,272564,8,9845,48
7/5/2021,N/A,US,Admin,USA,United States,55.5,49.4,0,340350467,397297,201969,340350467,184241436,231472,470700,208883,163965434,258766,27,9872,47
7/6/2021,N/A,US,Admin,USA,United States,55.6,49.5,0,340934978,584511,274882,340934978,184516318,228034,464361,337556,164302990,255790,38,9910,43
7/7/2021,N/A,US,Admin,USA,United States,55.7,49.6,0,341507537,572559,284608,341507537,184800926,224586,455826,320542,164623532,251391,37,9947,38
7/8/2021,N/A,US,Admin,USA,United States,55.7,49.7,0,342075868,568331,291257,342075868,185092183,224229,450208,312900,164936432,248244,43,9990,30
7/9/2021,N/A,US,Admin,USA,United States,55.8,49.8,0,342709369,633501,323504,342709369,185415687,226586,452018,345200,165281632,248763,23,10013,28
7/10/2021,N/A,US,Admin,USA,United States,55.9,49.8,0,343110639,401270,211681,343110639,185627368,230816,458264,206929,165488561,251339,15,10028,27
7/11/2021,N/A,US,Admin,USA,United States,55.9,49.9,0,343327576,216937,117000,343327576,185744368,243557,482058,107965,165596526,262854,6,10034,27
7/12/2021,N/A,US,Admin,USA,United States,56,50,0,343849047,521471,276102,343849047,186020470,254148,499797,273762,165870288,272122,20,10054,26
7/13/2021,N/A,US,Admin,USA,United States,56.1,50,0,344376788,527741,282118,344376788,186302588,255181,491687,271526,166141814,262689,19,10073,23
7/14/2021,N/A,US,Admin,USA,United States,56.2,50.1,0,344909199,532411,285076,344909199,186587664,255248,485952,272434,166414248,255817,27,10100,22
7/15/2021,N/A,US,Admin,USA,United States,56.3,50.2,0,345451343,542144,299154,345451343,186886818,256376,482211,268486,166682734,249472,23,10123,19
7/16/2021,N/A,US,Admin,USA,United States,56.4,50.3,0,346077475,626132,348225,346077475,187235043,259908,481158,302982,166985716,243441,27,10150,20
7/17/2021,N/A,US,Admin,USA,United States,56.5,50.4,0,346477805,400330,224283,346477805,187459326,261708,481024,189120,167174836,240896,21,10171,20
7/18/2021,N/A,US,Admin,USA,United States,56.5,50.4,0,346712081,234276,135743,346712081,187595069,264386,483501,105626,167280462,240562,9,10180,21
7/19/2021,N/A,US,Admin,USA,United States,56.6,50.5,0,347281474,569393,340668,347281474,187935737,273610,490347,252220,167532682,237485,27,10207,22
7/20/2021,N/A,US,Admin,USA,United States,56.7,50.5,0,347886227,604753,372963,347886227,188308700,286587,501348,256198,167788880,235295,28,10235,23
7/21/2021,N/A,US,Admin,USA,United States,56.8,50.6,0,348518762,632535,388529,348518762,188697229,301366,515652,267361,168056241,234570,23,10258,23
7/22/2021,N/A,US,Admin,USA,United States,57,50.7,0,349169755,650993,417854,349169755,189115083,318324,531202,257757,168313998,233038,33,10291,24
7/23/2021,N/A,US,Admin,USA,United States,57.1,50.8,0,349918485,748730,489270,349918485,189604353,338473,548716,287628,168601626,230844,31,10322,25
7/24/2021,N/A,US,Admin,USA,United States,57.2,50.8,0,350382022,463537,302364,350382022,189906717,349627,557745,174235,168775861,228718,17,10339,24
7/25/2021,N/A,US,Admin,USA,United States,57.3,50.9,0,350641467,259445,202148,350641467,190108865,359114,561341,63075,168838936,222639,9,10348,24
7/26/2021,N/A,US,Admin,USA,United States,57.4,50.9,0,351285982,644515,448310,351285982,190557175,374491,572073,221292,169060228,218221,40,10388,26
7/27/2021,N/A,US,Admin,USA,United States,57.5,51,0,351988157,702175,481242,351988157,191038417,389960,585990,251794,169312022,217592,28,10416,26
7/28/2021,N/A,US,Admin,USA,United States,57.7,51.1,0,352709520,721363,492159,352709520,191530576,404764,598680,259244,169571266,216432,35,10451,28
7/29/2021,N/A,US,Admin,USA,United States,57.8,51.2,0,353430902,721382,498361,353430902,192028937,416265,608735,253255,169824521,215789,36,10487,28
7/30/2021,N/A,US,Admin,USA,United States,58,51.2,0,354267450,836548,576575,354267450,192605512,428737,621281,291531,170116052,216347,58,10545,32
7/31/2021,N/A,US,Admin,USA,United States,58.1,51.3,0,354783153,515703,346840,354783153,192952352,435091,628733,180468,170296520,217237,35,10580,34
8/1/2021,N/A,US,Admin,USA,United States,58.2,51.3,0,355112890,329737,226927,355112890,193179279,438631,638775,99657,170396177,222463,85,10665,45
8/2/2021,N/A,US,Admin,USA,United States,58.3,51.4,0,355834060,721170,506984,355834060,193686263,447013,649725,239056,170635233,225001,50,10715,47
8/3/2021,N/A,US,Admin,USA,United States,58.5,51.5,0,356597232,763172,538720,356597232,194224983,455224,658439,254077,170889310,225327,28,10743,47
8/4/2021,N/A,US,Admin,USA,United States,58.7,51.5,0,357376232,779000,553025,357376232,194778008,463919,666673,255827,171145137,224839,28,10771,46
8/5/2021,N/A,US,Admin,USA,United States,58.8,51.6,0,358170020,793788,560596,358170020,195338604,472810,677017,265082,171410219,226528,36,10807,46
8/6/2021,N/A,US,Admin,USA,United States,59,51.7,0,359079687,909667,626773,359079687,195965377,479981,687462,312045,171722264,229459,28,10835,41
8/7/2021,N/A,US,Admin,USA,United States,59.1,51.8,0,359638248,558561,381851,359638248,196347228,484982,693585,190002,171912266,230821,18,10853,39
8/8/2021,N/A,US,Admin,USA,United States,59.2,51.8,0,359989063,350815,237817,359989063,196585045,486538,696596,117835,172030101,233418,17,10870,29
8/9/2021,N/A,US,Admin,USA,United States,59.4,51.9,0,360772767,783704,520892,360772767,197105937,488525,705530,287291,172317392,240308,41,10911,28
8/10/2021,N/A,US,Admin,USA,United States,59.5,52,0,361574535,801768,531482,361574535,197637419,487491,711043,296018,172613410,246300,36,10947,29
8/11/2021,N/A,US,Admin,USA,United States,59.7,52.1,0,362345258,770723,499773,362345258,198137192,479883,709861,296475,172909885,252107,40,10987,31
8/12/2021,N/A,US,Admin,USA,United States,59.8,52.2,0,363150411,805153,515476,363150411,198652668,473438,711484,314486,173224371,259165,48,11035,33
8/13/2021,N/A,US,Admin,USA,United States,60,52.3,0,364100439,950028,581538,364100439,199234206,466976,717250,390003,173614374,270301,14459,25494,2094
8/14/2021,N/A,US,Admin,USA,United States,60.1,52.4,0,364727619,627180,362641,364727619,199596847,464231,727053,242804,173857178,277845,36994,62488,7376
8/15/2021,N/A,US,Admin,USA,United States,60.2,52.4,0.1,365129177,401558,212152,365129177,199808999,460565,734302,161869,174019047,284135,33932,96420,12221
8/16/2021,N/A,US,Admin,USA,United States,60.3,52.5,0.1,366004797,875620,465997,366004797,200274996,452723,747433,354923,174373970,293797,81665,178085,23882
8/17/2021,N/A,US,Admin,USA,United States,60.5,52.6,0.2,366934609,929812,491788,366934609,200766784,447052,765725,364559,174738529,303588,101050,279135,38313
8/18/2021,N/A,US,Admin,USA,United States,60.6,52.7,0.2,367894365,959756,488526,367894365,201255310,445445,792730,379919,175118448,315509,118412,397547,55223
8/19/2021,N/A,US,Admin,USA,United States,60.8,52.9,0.3,368846183,951818,481731,368846183,201737041,440625,813682,382083,175500531,325166,115893,513440,71772
8/20/2021,N/A,US,Admin,USA,United States,60.9,53,0.4,369960101,1113918,539708,369960101,202276749,434649,837095,479547,175980078,337958,123446,636886,87342
8/21/2021,N/A,US,Admin,USA,United States,61,53.1,0.4,370629374,669273,322588,370629374,202599337,428927,843108,297947,176278025,345835,62451,699337,90978
8/22/2021,N/A,US,Admin,USA,United States,61.1,53.1,0.4,371022441,393067,186357,371022441,202785694,425242,841895,180108,176458133,348441,32167,731504,90726
8/23/2021,N/A,US,Admin,USA,United States,61.2,53.3,0.5,371948597,926156,443707,371948597,203229401,422058,849114,405928,176864061,355727,98139,829643,93080
8/24/2021,N/A,US,Admin,USA,United States,61.4,53.4,0.5,372904592,955995,463971,372904592,203693372,418084,852855,415814,177279875,363049,101544,931187,93150
8/25/2021,N/A,US,Admin,USA,United States,61.5,53.5,0.6,373877328,972736,471677,373877328,204165049,415677,854709,423474,177703349,369272,104547,1035734,91170
8/26/2021,N/A,US,Admin,USA,United States,61.6,53.7,0.6,374873929,996601,478802,374873929,204643851,415259,861107,433655,178137004,376639,112027,1147761,90617
8/27/2021,N/A,US,Admin,USA,United States,61.8,53.8,0.7,376051821,1177892,537054,376051821,205180905,414879,870246,540898,178677902,385403,127604,1275365,91211
8/28/2021,N/A,US,Admin,USA,United States,61.9,53.9,0.7,376766750,714929,320314,376766750,205501219,414555,876768,341397,179019299,391611,64759,1340124,91541
8/29/2021,N/A,US,Admin,USA,United States,62,54,0.8,377198595,431845,194246,377198595,205695465,415682,882308,205851,179225150,395288,36140,1376264,92109
8/30/2021,N/A,US,Admin,USA,United States,62.1,54.1,0.8,378129529,930934,419043,378129529,206114508,412158,882990,432242,179657392,399047,101113,1477377,92533
8/31/2021,N/A,US,Admin,USA,United States,62.2,54.2,0.9,379061413,931884,419908,379061413,206534416,405863,879546,421859,180079251,399911,110876,1588253,93867
9/1/2021,N/A,US,Admin,USA,United States,62.3,54.4,1,380005693,944280,428845,380005693,206963261,399745,875481,409785,180489036,397955,127156,1715409,97096
9/2/2021,N/A,US,Admin,USA,United States,62.5,54.5,1,380906001,900308,405582,380906001,207368843,389285,861725,401841,180890877,393410,115554,1830963,97600
9/3/2021,N/A,US,Admin,USA,United States,62.6,54.6,1.1,381951664,1045663,456005,381951664,207824848,377706,842835,490963,181381840,386277,120536,1951499,96591
9/4/2021,N/A,US,Admin,USA,United States,62.7,54.7,1.1,382514041,562377,246814,382514041,208071662,367206,821042,278074,181659914,377231,45175,1996674,93793
9/5/2021,N/A,US,Admin,USA,United States,62.7,54.8,1.1,382881425,367384,168309,382881425,208239971,363501,811833,173760,181833674,372646,28083,2024757,92642
9/6/2021,N/A,US,Admin,USA,United States,62.7,54.8,1.1,383059611,178186,82508,383059611,208322479,315424,704297,87401,181921075,323383,12208,2036965,79941
9/7/2021,N/A,US,Admin,USA,United States,62.9,54.9,1.2,383971348,911737,355188,383971348,208677667,306179,701419,480620,182401695,331778,93442,2130407,77451
9/8/2021,N/A,US,Admin,USA,United States,63,55.1,1.2,384818720,847372,366874,384818720,209044541,297326,687575,402583,182804278,330749,97053,2227460,73150
9/9/2021,N/A,US,Admin,USA,United States,63.1,55.2,1.3,385668347,849627,373137,385668347,209417678,292691,680335,398073,183202351,330211,98589,2326049,70727
9/10/2021,N/A,US,Admin,USA,United States,63.2,55.3,1.3,386705363,1037016,450488,386705363,209868166,291903,679100,500835,183703186,331621,108321,2434370,68982
9/11/2021,N/A,US,Admin,USA,United States,63.3,55.4,1.3,387303518,598155,258639,387303518,210126805,293592,684211,300789,184003975,334866,49266,2483636,69566
9/12/2021,N/A,US,Admin,USA,United States,63.3,55.5,1.4,387654331,350813,157184,387654331,210283989,292003,681844,173966,184177941,334895,23365,2507001,68892
9/13/2021,N/A,US,Admin,USA,United States,63.4,55.6,1.4,388437743,783412,338326,388437743,210622315,328548,768305,384776,184562717,377377,76809,2583810,78121
9/14/2021,N/A,US,Admin,USA,United States,63.5,55.7,1.4,389189193,751450,316516,389189193,210938831,323023,745406,379091,184941808,362873,75325,2659135,75533
9/15/2021,N/A,US,Admin,USA,United States,63.6,55.8,1.5,389953309,764116,313126,389953309,211251957,315345,733513,390478,185332286,361144,79573,2738708,73035
9/16/2021,N/A,US,Admin,USA,United States,63.7,55.9,1.5,390715203,761894,311326,390715203,211563283,306515,720979,393327,185725613,360466,78175,2816883,70119
9/17/2021,N/A,US,Admin,USA,United States,63.8,56.1,1.6,391619391,904188,351606,391619391,211914889,292389,702004,482942,186208555,357910,91030,2907913,67649
9/18/2021,N/A,US,Admin,USA,United States,63.9,56.2,1.6,392142015,522624,205421,392142015,212120310,284786,691214,276506,186485061,354441,49043,2956956,67617
9/19/2021,N/A,US,Admin,USA,United States,63.9,56.2,1.6,392447940,305925,119536,392447940,212239846,279408,684801,165755,186650816,353268,23615,2980571,67653
9/20/2021,N/A,US,Admin,USA,United States,64,56.3,1.6,393138616,690676,266118,393138616,212505964,269093,671553,352814,187003630,348702,87113,3067684,69125
9/21/2021,N/A,US,Admin,USA,United States,64.1,56.4,1.7,393816488,677872,261804,393816488,212767768,261277,661042,344277,187347907,343728,90030,3157714,71226
9/22/2021,N/A,US,Admin,USA,United States,64.2,56.5,1.7,394482470,665982,254196,394482470,213021964,252858,647023,337109,187685016,336104,86584,3244298,72227
9/23/2021,N/A,US,Admin,USA,United States,64.2,56.6,1.8,395158523,676053,255730,395158523,213277694,244916,634760,329893,188014909,327042,103494,3347792,75844
9/24/2021,N/A,US,Admin,USA,United States,64.3,56.8,1.9,396145428,986905,321810,396145428,213599504,240659,646577,415188,188430097,317363,260518,3608310,100057
9/25/2021,N/A,US,Admin,USA,United States,64.4,56.8,2,396818543,673115,203143,396818543,213802647,240334,668075,229825,188659922,310694,242803,3851113,127737
9/26/2021,N/A,US,Admin,USA,United States,64.4,56.9,2.1,397228506,409963,120301,397228506,213922948,240443,682938,146282,188806204,307913,144005,3995118,144935
9/27/2021,N/A,US,Admin,USA,United States,64.5,56.9,2.4,398258849,1030343,299726,398258849,214222674,245244,731462,224517,189030721,289584,511628,4506746,205580
9/28/2021,N/A,US,Admin,USA,United States,64.6,57,2.7,399391159,1132310,291905,399391159,214514579,249544,796382,305256,189335977,284010,541311,5048057,270049
9/29/2021,N/A,US,Admin,USA,United States,64.7,57.1,2.9,400530174,1139015,290089,400530174,214804668,254672,863958,313217,189649194,280597,543945,5592002,335386
9/30/2021,N/A,US,Admin,USA,United States,64.8,57.2,3.2,401690891,1160717,290818,401690891,215095486,259685,933195,322710,189971904,279571,557252,6149254,400209
10/1/2021,N/A,US,Admin,USA,United States,64.9,57.3,3.6,403007530,1316639,316969,403007530,215412455,258993,980300,382422,190354326,274890,624268,6773522,452173
10/2/2021,N/A,US,Admin,USA,United States,64.9,57.4,3.7,403636765,629235,174266,403636765,215586721,254868,974032,207828,190562154,271747,251744,7025266,453450
10/3/2021,N/A,US,Admin,USA,United States,65,57.4,3.8,404002859,366094,106577,404002859,215693298,252907,967765,130863,190693017,269545,129967,7155233,451445
10/4/2021,N/A,US,Admin,USA,United States,65,57.5,4,404985113,982254,248090,404985113,215941388,245531,960895,258578,190951595,274411,483044,7638277,447362
10/5/2021,N/A,US,Admin,USA,United States,65.1,57.6,4.3,405999037,1013924,245223,405999037,216186611,238862,943983,258331,191209926,267707,518876,8157153,444157
10/6/2021,N/A,US,Admin,USA,United States,65.2,57.7,4.5,407027725,1028688,249040,407027725,216435651,232998,928222,260284,191470210,260145,527966,8685119,441874
10/7/2021,N/A,US,Admin,USA,United States,65.3,57.7,4.8,408041901,1014176,251411,408041901,216687062,227368,907287,257875,191728085,250883,514536,9199655,435772
10/8/2021,N/A,US,Admin,USA,United States,65.4,57.8,5.1,409183520,1141619,283990,409183520,216971052,222657,882284,312027,192040112,240827,555768,9755423,425986
10/9/2021,N/A,US,Admin,USA,United States,65.4,57.9,5.2,409718872,535352,147898,409718872,217118950,218890,868872,168748,192208860,235244,223522,9978945,421954
10/10/2021,N/A,US,Admin,USA,United States,65.4,57.9,5.2,410033024,314152,93249,410033024,217212199,216986,861452,105205,192314065,231578,116729,10095674,420063
10/11/2021,N/A,US,Admin,USA,United States,65.5,58,5.5,410886852,853828,226335,410886852,217438534,213878,843106,221698,192535763,226310,413387,10509061,410112
10/12/2021,N/A,US,Admin,USA,United States,65.6,58.1,5.7,411811329,924477,229446,411811329,217667980,211624,830327,235494,192771257,223047,469168,10978229,403011
10/13/2021,N/A,US,Admin,USA,United States,65.6,58.1,5.9,412715668,904339,228195,412715668,217896175,208646,812563,230260,193001517,218758,456903,11435132,392859
10/14/2021,N/A,US,Admin,USA,United States,65.7,58.2,6.2,413624713,909045,226644,413624713,218122819,205108,797545,230501,193232018,214848,463539,11898671,385574
10/15/2021,N/A,US,Admin,USA,United States,65.8,58.3,6.4,414674757,1050044,262374,414674757,218385193,202020,784462,279211,193511229,210160,520197,12418868,380492
10/16/2021,N/A,US,Admin,USA,United States,65.8,58.3,6.5,415165633,490876,141133,415165633,218526326,201054,778109,145252,193656481,206803,210118,12628986,378577
10/17/2021,N/A,US,Admin,USA,United States,65.8,58.4,6.6,415434867,269234,83982,415434867,218610308,199730,771692,84519,193741000,203848,102245,12731231,376508
10/18/2021,N/A,US,Admin,USA,United States,65.9,58.4,6.8,416264378,829511,223808,416264378,218834116,199369,768218,212217,193953217,202493,403021,13134252,375027
10/19/2021,N/A,US,Admin,USA,United States,66,58.5,7,417084566,820188,202642,417084566,219036758,195540,753320,193558,194146775,196503,433338,13567590,369909
10/20/2021,N/A,US,Admin,USA,United States,66,58.5,7.2,417918614,834048,203832,417918614,219240590,192059,743278,195205,194341980,191495,444565,14012155,368146
10/21/2021,N/A,US,Admin,USA,United States,66.1,58.6,7.4,418774327,855713,207327,418774327,219447917,189300,735659,197837,194539817,186828,459981,14472136,367638
10/22/2021,N/A,US,Admin,USA,United States,66.2,58.7,7.9,420153906,1379579,293275,420153906,219741192,193714,782736,247065,194786882,182236,843120,15315256,413770
10/23/2021,N/A,US,Admin,USA,United States,66.2,58.7,8.1,420984379,830473,176368,420984379,219917560,198748,831249,134010,194920892,180630,519692,15834948,457995
10/24/2021,N/A,US,Admin,USA,United States,66.3,58.7,8.3,421457968,473589,108095,421457968,220025655,202192,860443,80582,195001474,180068,283767,16118715,483926
10/25/2021,N/A,US,Admin,USA,United States,66.4,58.8,8.8,422986160,1528192,303186,422986160,220328841,213532,960255,205069,195206543,179047,1018644,17137359,571872
10/26/2021,N/A,US,Admin,USA,United States,66.5,58.9,9.3,424551481,1565321,298973,424551481,220627814,227294,1066702,202935,195409478,180386,1065947,18203306,662245
10/27/2021,N/A,US,Admin,USA,United States,66.5,58.9,9.9,426172451,1620970,307596,426172451,220935410,242117,1179120,207892,195617370,182199,1109675,19312981,757261
10/28/2021,N/A,US,Admin,USA,United States,66.6,59,10.4,427778771,1606320,298018,427778771,221233428,255073,1286349,209363,195826733,183845,1104843,20417824,849384
10/29/2021,N/A,US,Admin,USA,United States,66.7,59.1,11,429562325,1783554,327313,429562325,221560741,259936,1344060,238680,196065413,182647,1223399,21641223,903710
10/30/2021,N/A,US,Admin,USA,United States,66.8,59.1,11.3,430381783,819458,167306,430381783,221728047,258641,1342486,119553,196184966,180582,536856,22178079,906162
10/31/2021,N/A,US,Admin,USA,United States,66.8,59.1,11.4,430819360,437577,100442,430819360,221828489,257548,1337342,70761,196255727,179179,267326,22445405,903813
11/1/2021,N/A,US,Admin,USA,United States,66.9,59.2,11.9,432284752,1465392,285277,432284752,222113766,254989,1328370,196086,196451813,177896,986159,23431564,899172
11/2/2021,N/A,US,Admin,USA,United States,67,59.2,12.4,433784461,1499709,284483,433784461,222398249,252919,1318997,189078,196640891,175916,1035170,24466734,894775
11/3/2021,N/A,US,Admin,USA,United States,67.1,59.3,13,435345872,1561411,312421,435345872,222710670,253609,1310489,192705,196833596,173747,1065653,25532387,888487
11/4/2021,N/A,US,Admin,USA,United States,67.2,59.3,13.5,436980436,1634564,352010,436980436,223062680,261322,1314524,195647,197029243,171787,1097402,26629789,887424
11/5/2021,N/A,US,Admin,USA,United States,67.3,59.4,14.1,438890695,1910259,455585,438890695,223518265,279646,1332624,230382,197259625,170602,1235179,27864968,889106
11/6/2021,N/A,US,Admin,USA,United States,67.4,59.4,14.4,439923977,1033282,390426,439923977,223908691,311521,1363171,118179,197377804,170405,530459,28395427,888193
11/7/2021,N/A,US,Admin,USA,United States,67.5,59.5,14.5,440479030,555053,228749,440479030,224137440,329850,1379953,70748,197448552,170404,259283,28654710,887044
11/8/2021,N/A,US,Admin,USA,United States,67.7,59.5,14.9,441940253,1461223,472453,441940253,224609893,356590,1379357,173652,197622204,167199,824367,29479077,863930
11/9/2021,N/A,US,Admin,USA,United States,67.8,59.6,15.4,443574603,1634350,523720,443574603,225133613,390766,1398592,166774,197788978,164012,950268,30429345,851802
11/10/2021,N/A,US,Admin,USA,United States,68,59.6,15.9,445339715,1765112,574838,445339715,225708451,428254,1427692,171036,197960014,160917,1025011,31454356,845996
11/11/2021,N/A,US,Admin,USA,United States,68.1,59.7,16.3,446940323,1600608,550701,446940323,226259152,456639,1422841,154173,198114187,154992,901027,32355383,817942
11/12/2021,N/A,US,Admin,USA,United States,68.3,59.7,16.9,448929328,1989005,641046,448929328,226900198,483133,1434090,200066,198314253,150661,1155678,33511061,806585
11/13/2021,N/A,US,Admin,USA,United States,68.5,59.8,17.2,450103410,1174082,536197,450103410,227436395,503958,1454205,103270,198417523,148531,537151,34048212,807541
11/14/2021,N/A,US,Admin,USA,United States,68.6,59.8,17.3,450682084,578674,240662,450682084,227677057,505660,1457579,60815,198478338,147112,279384,34327596,810412
11/15/2021,N/A,US,Admin,USA,United States,68.7,59.8,17.7,452231235,1549151,462178,452231235,228139235,504192,1470140,167876,198646214,146287,925442,35253038,824852
11/16/2021,N/A,US,Admin,USA,United States,68.9,59.9,18.2,453910682,1679447,489906,453910682,228629141,499361,1476583,168058,198814272,146471,1029330,36282368,836146
11/17/2021,N/A,US,Admin,USA,United States,69,59.9,18.8,455668082,1757400,508478,455668082,229137619,489881,1475481,173508,198987780,146824,1082580,37364948,844370
11/18/2021,N/A,US,Admin,USA,United States,69.2,60,19.3,457452740,1784658,508647,457452740,229646266,483873,1501774,172189,199159969,149397,1111800,38476748,874481
11/19/2021,N/A,US,Admin,USA,United States,69.3,60,20,459522392,2069652,584682,459522392,230230948,475821,1513295,196057,199356026,148825,1296439,39773187,894589
11/20/2021,N/A,US,Admin,USA,United States,69.5,60.1,20.3,460753708,1231316,460484,460753708,230691432,465005,1521471,101328,199457354,148547,673090,40446277,914009
11/21/2021,N/A,US,Admin,USA,United States,69.5,60.1,20.5,461397106,643398,206601,461397106,230898033,460139,1530717,60366,199517720,148483,377451,40823728,928019
11/22/2021,N/A,US,Admin,USA,United States,69.7,60.1,21,463206090,1808984,490911,463206090,231388944,464244,1567836,172259,199689979,149109,1151586,41975314,960325
11/23/2021,N/A,US,Admin,USA,United States,69.8,60.2,21.6,464991818,1785728,492016,464991818,231880960,464546,1583019,166531,199856510,148891,1133892,43109206,975263
11/24/2021,N/A,US,Admin,USA,United States,70,60.2,22,466372775,1380957,403504,466372775,232284464,449549,1529242,155187,200011697,146274,829835,43939041,939156
11/25/2021,N/A,US,Admin,USA,United States,70,60.2,22,466400671,27896,8954,466400671,232293418,378165,1278276,5171,200016868,122414,13588,43952629,782269
11/26/2021,N/A,US,Admin,USA,United States,70.1,60.3,22.3,467605108,1204437,312303,467605108,232605721,339253,1154674,177136,200194004,119711,718672,44671301,699731
11/27/2021,N/A,US,Admin,USA,United States,70.1,60.4,22.5,468497239,892131,220620,468497239,232826341,304987,1106219,199545,200393549,133742,474764,45146065,671398
11/28/2021,N/A,US,Admin,USA,United States,70.2,60.4,22.7,469087127,589888,142606,469087127,232968947,295845,1098574,148037,200541586,146267,300561,45446626,660414
11/29/2021,N/A,US,Admin,USA,United States,70.3,60.5,23.1,470744866,1657739,356015,470744866,233324962,276574,1076968,361883,200903469,173356,947428,46394054,631249
11/30/2021,N/A,US,Admin,USA,United States,70.4,60.6,23.6,472662315,1917449,406881,472662315,233731843,264412,1095785,392168,201295637,205590,1126779,47520833,630232
12/1/2021,N/A,US,Admin,USA,United States,70.5,60.8,24.2,474809338,2147023,460341,474809338,234192184,272531,1205223,410201,201705838,242020,1280624,48801457,694631
12/2/2021,N/A,US,Admin,USA,United States,70.7,60.9,24.8,476962640,2153302,448705,476962640,234640889,335353,1508853,395070,202100908,297720,1317336,50118793,880881
12/3/2021,N/A,US,Admin,USA,United States,70.8,61,25.5,479390402,2427762,487763,479390402,235128652,360419,1683613,492517,202593425,342774,1455122,51573915,986088
12/4/2021,N/A,US,Admin,USA,United States,70.9,61.2,25.8,480865824,1475422,301525,480865824,235430177,371977,1766941,453061,203046486,378991,723882,52297797,1021676
12/5/2021,N/A,US,Admin,USA,United States,71,61.2,25.9,481593276,727452,165724,481593276,235595901,375279,1786593,189959,203236445,384980,373700,52671497,1032124
12/6/2021,N/A,US,Admin,USA,United States,71.1,61.3,26.4,483415855,1822579,390601,483415855,235986502,380220,1810141,326512,203562957,379927,1109796,53781293,1055320
12/7/2021,N/A,US,Admin,USA,United States,71.2,61.4,26.9,485316265,1900410,403043,485316265,236389545,379672,1807707,342324,203905281,372806,1159718,54941011,1060025
12/8/2021,N/A,US,Admin,USA,United States,71.3,61.5,27.5,487231354,1915089,407877,487231354,236797422,372177,1774574,353604,204258885,364721,1159584,56100595,1042734
12/9/2021,N/A,US,Admin,USA,United States,71.4,61.6,28,489143788,1912434,405107,489143788,237202529,365949,1740164,340936,204599821,356988,1172241,57272836,1022006
12/10/2021,N/A,US,Admin,USA,United States,71.6,61.7,28.6,491240989,2097201,424718,491240989,237627247,356942,1692941,397942,204997763,343477,1278954,58551790,996839
12/11/2021,N/A,US,Admin,USA,United States,71.7,61.8,28.8,492493800,1252811,267331,492493800,237894578,352057,1661139,337272,205335035,326936,650910,59202700,986415
12/12/2021,N/A,US,Admin,USA,United States,71.7,61.9,29,493122074,628274,151640,493122074,238046218,350045,1646971,129931,205464966,318360,348937,59551637,982877
12/13/2021,N/A,US,Admin,USA,United States,71.8,62,29.4,494730406,1608332,347914,494730406,238394132,343947,1616364,279591,205744557,311657,986167,60537804,965216
12/14/2021,N/A,US,Admin,USA,United States,71.9,62.1,29.9,496435705,1705299,367422,496435705,238761554,338858,1588491,287266,206031823,303792,1057379,61595183,950596
12/15/2021,N/A,US,Admin,USA,United States,72,62.1,30.4,498143020,1707315,379261,498143020,239140815,334770,1558809,261591,206293414,290647,1071985,62667168,938082
12/16/2021,N/A,US,Admin,USA,United States,72.1,62.2,30.9,499821322,1678302,390560,499821322,239531375,332692,1525362,170393,206463807,266284,1123307,63790475,931091
12/17/2021,N/A,US,Admin,USA,United States,72.3,62.3,31.5,501742231,1920909,433521,501742231,239964896,333950,1500177,252872,206716679,245559,1236100,65026575,924969
12/18/2021,N/A,US,Admin,USA,United States,72.4,62.3,31.8,502859393,1117162,288353,502859393,240253249,336953,1480799,163329,206880008,220710,665862,65692437,927105
12/19/2021,N/A,US,Admin,USA,United States,72.4,62.3,31.9,503497518,638125,169472,503497518,240422721,339500,1482206,81950,206961958,213856,386674,66079111,932496
12/20/2021,N/A,US,Admin,USA,United States,72.5,62.4,32.5,505327431,1829913,442569,505327431,240865290,353023,1513861,227210,207189168,206373,1160665,67239776,957425
12/21/2021,N/A,US,Admin,USA,United States,72.7,62.5,33,507285910,1958479,467838,507285910,241333128,367368,1550029,243088,207432256,200062,1247045,68486821,984520
12/22/2021,N/A,US,Admin,USA,United States,72.8,62.5,33.5,509135654,1849744,447427,509135654,241780555,377106,1570376,239210,207671466,196865,1164304,69651125,997708
12/23/2021,N/A,US,Admin,USA,United States,72.9,62.6,33.9,510586566,1450912,368754,510586566,242149309,373991,1537892,178260,207849726,197988,905112,70556237,966537
12/24/2021,N/A,US,Admin,USA,United States,73,62.6,34,510964797,378231,103595,510964797,242252904,326858,1317509,56681,207906407,169961,219274,70775511,821277
12/25/2021,N/A,US,Admin,USA,United States,73,62.6,34,510971244,6447,2083,510971244,242254987,285963,1158836,924,207907331,146760,3347,70778858,726632
12/26/2021,N/A,US,Admin,USA,United States,73,62.6,34.2,511448714,477470,132404,511448714,242387391,280667,1135885,83486,207990817,146980,261841,71040699,708798
12/27/2021,N/A,US,Admin,USA,United States,73.1,62.7,34.5,512965835,1517121,395705,512965835,242783096,273972,1091201,230155,208220972,147401,892871,71933570,670542
12/28/2021,N/A,US,Admin,USA,United States,73.3,62.8,35,514642665,1676830,435461,514642665,243218557,269347,1050965,241572,208462544,147184,1001529,72935099,635468
12/29/2021,N/A,US,Admin,USA,United States,73.4,62.9,35.4,516302000,1659335,436468,516302000,243655025,267781,1023764,236998,208699542,146868,987618,73922717,610227
12/30/2021,N/A,US,Admin,USA,United States,73.5,62.9,35.8,517818110,1516110,403492,517818110,244058517,272744,1033078,214524,208914066,152049,900116,74822833,609514
12/31/2021,N/A,US,Admin,USA,United States,73.6,63,36,518421971,603861,161874,518421971,244220391,281070,1065311,93293,209007359,157279,349220,75172053,628077
1/1/2022,N/A,US,Admin,USA,United States,73.6,63,36,518525715,103744,33270,518525715,244253661,285525,1079210,16182,209023541,159459,52732,75224785,635132
1/2/2022,N/A,US,Admin,USA,United States,73.6,63,36.1,519019757,494042,137318,519019757,244390979,286227,1081578,90449,209113990,160453,266938,75491723,635861
1/3/2022,N/A,US,Admin,USA,United States,73.7,63,36.4,520248320,1228563,343092,520248320,244734071,278711,1040355,196838,209310828,155694,691702,76183425,607122
1/4/2022,N/A,US,Admin,USA,United States,73.8,63.1,36.7,521648038,1399718,374613,521648038,245108684,270018,1000768,214441,209525269,151818,814137,76997562,580352
1/5/2022,N/A,US,Admin,USA,United States,73.9,63.2,37.1,523078768,1430730,381953,523078768,245490637,262230,968110,213086,209738355,148402,839457,77837019,559186
1/6/2022,N/A,US,Admin,USA,United States,74.1,63.2,37.5,524518778,1440010,372087,524518778,245862724,257744,957238,212338,209950693,148090,858906,78695925,553299
1/7/2022,N/A,US,Admin,USA,United States,74.2,63.3,37.9,526138193,1619415,401499,526138193,246264223,291976,1102317,245193,210195886,169790,975560,79671485,642776
1/8/2022,N/A,US,Admin,USA,United States,74.3,63.4,38.2,527175083,1036890,276096,527175083,246540319,326665,1235624,174612,210370498,192422,587345,80258830,719149
1/9/2022,N/A,US,Admin,USA,United States,74.3,63.4,38.3,527667339,492256,142642,527667339,246682961,327426,1235369,74773,210445271,190183,275799,80534629,720415
1/10/2022,N/A,US,Admin,USA,United States,74.4,63.4,38.6,528910308,1242969,332707,528910308,247015668,325942,1237427,190172,210635443,189231,723227,81257856,724919
1/11/2022,N/A,US,Admin,USA,United States,74.5,63.5,38.9,530201530,1291222,341329,530201530,247356997,321188,1221927,201622,210837065,187399,750995,82008851,715898
1/12/2022,N/A,US,Admin,USA,United States,74.6,63.6,39.2,531493762,1292232,342906,531493762,247699903,315609,1202142,200209,211037274,185560,752197,82761048,703433
1/13/2022,N/A,US,Admin,USA,United States,74.7,63.6,39.5,532764877,1271115,339343,532764877,248039246,310932,1178014,188653,211225927,182176,745350,83506398,687210
1/14/2022,N/A,US,Admin,USA,United States,74.8,63.7,39.9,534215905,1451028,381714,534215905,248420960,308105,1153959,174917,211400844,172137,894318,84400716,675604
1/15/2022,N/A,US,Admin,USA,United States,74.9,63.7,40.1,534998627,782722,228455,534998627,248649415,301299,1117649,87578,211488422,159703,465880,84866596,658252
1/16/2022,N/A,US,Admin,USA,United States,74.9,63.7,40.2,535386729,388102,107357,535386729,248756772,296259,1102770,57908,211546330,157294,222775,85089371,650677
1/17/2022,N/A,US,Admin,USA,United States,75,63.8,40.4,536206708,819979,218363,536206708,248975135,279924,1042343,140831,211687161,150245,460052,85549423,613081
1/18/2022,N/A,US,Admin,USA,United States,75.1,63.8,40.6,537192964,986256,256932,537192964,249232067,267867,998776,188181,211875342,148325,540141,86089564,582959
1/19/2022,N/A,US,Admin,USA,United States,75.1,63.9,40.8,538159671,966707,255711,538159671,249487778,255411,952273,186362,212061704,146347,523418,86612982,550276
1/20/2022,N/A,US,Admin,USA,United States,75.2,63.9,41,539082760,923089,244950,539082760,249732728,241926,902555,175781,212237485,144508,500604,87113586,515313
1/21/2022,N/A,US,Admin,USA,United States,75.3,64,41.3,540146106,1063346,282341,540146106,250015069,227730,847172,160565,212398050,142458,618140,87731726,475859
1/22/2022,N/A,US,Admin,USA,United States,75.4,64,41.5,540759678,613572,175373,540759678,250190442,220147,823007,82652,212480702,141754,353728,88085454,459837
1/23/2022,N/A,US,Admin,USA,United States,75.4,64,41.5,541089021,329343,93151,541089021,250283593,218117,814613,64042,212544744,142631,171743,88257197,452547
1/24/2022,N/A,US,Admin,USA,United States,75.4,64.1,41.7,541876684,787663,208657,541876684,250492250,216731,809997,159849,212704593,145347,417067,88674264,446406
1/25/2022,N/A,US,Admin,USA,United States,75.5,64.1,41.8,542669703,793019,208249,542669703,250700499,209776,782391,174660,212879253,143416,407873,89082137,427510
1/26/2022,N/A,US,Admin,USA,United States,75.6,64.2,42,543450572,780869,204816,543450572,250905315,202505,755843,178085,213057338,142233,395759,89477896,409273
1/27/2022,N/A,US,Admin,USA,United States,75.6,64.2,42.1,544229833,779261,202798,544229833,251108113,196484,735296,174158,213231496,142002,398914,89876810,394746
1/28/2022,N/A,US,Admin,USA,United States,75.7,64.3,42.3,545171164,941331,233711,545171164,251341824,189536,717865,208871,213440367,148902,493521,90370331,376944
1/29/2022,N/A,US,Admin,USA,United States,75.7,64.3,42.4,545637189,466025,123975,545637189,251465799,182194,696787,111532,213551899,153028,228287,90598618,359023
1/30/2022,N/A,US,Admin,USA,United States,75.8,64.3,42.5,545900067,262878,73637,545900067,251539436,179406,687292,66890,213618789,153435,121434,90720052,351836
1/31/2022,N/A,US,Admin,USA,United States,75.8,64.4,42.6,546522863,622796,163247,546522863,251702683,172919,663740,157581,213776370,153111,298580,91018632,334910
2/1/2022,N/A,US,Admin,USA,United States,75.9,64.4,42.7,547124494,601631,152261,547124494,251854944,164921,636399,158264,213934634,150769,286356,91304988,317550
2/2/2022,N/A,US,Admin,USA,United States,75.9,64.5,42.8,547686665,562171,146676,547686665,252001620,156615,605156,153222,214087856,147217,259475,91564463,298081
2/3/2022,N/A,US,Admin,USA,United States,75.9,64.5,42.9,548197247,510582,130976,548197247,252132596,146355,566773,138791,214226647,142164,237935,91802398,275084
2/4/2022,N/A,US,Admin,USA,United States,76,64.6,43,548843919,646672,156722,548843919,252289318,135356,524679,182742,214409389,138432,303195,92105593,247895
2/5/2022,N/A,US,Admin,USA,United States,76,64.6,43,549278423,434504,112139,549278423,252401457,133665,520176,131679,214541068,141310,188079,92293672,242151
2/6/2022,N/A,US,Admin,USA,United States,76,64.6,43,549490175,211752,61111,549490175,252462568,131876,512873,60073,214601141,140336,89410,92383082,237576
2/7/2022,N/A,US,Admin,USA,United States,76.1,64.7,43.1,549966731,476556,130467,549966731,252593035,127193,491981,130929,214732070,136529,210627,92593709,225011
2/8/2022,N/A,US,Admin,USA,United States,76.1,64.7,43.2,550460658,493927,127445,550460658,252720480,123648,476595,144260,214876330,134528,217182,92810891,215129
2/9/2022,N/A,US,Admin,USA,United States,76.2,64.8,43.3,550963804,503146,131551,550963804,252852031,121487,468163,144068,215020398,133220,223056,93033947,209926
2/10/2022,N/A,US,Admin,USA,United States,76.2,64.8,43.3,551463694,499890,129593,551463694,252981624,121290,466635,138487,215158885,133177,226812,93260759,208337
2/11/2022,N/A,US,Admin,USA,United States,76.2,64.9,43.4,552078035,614341,153812,552078035,253135436,120874,462017,172159,215331044,131665,282149,93542908,205331
2/12/2022,N/A,US,Admin,USA,United States,76.3,64.9,43.5,552421377,343342,92810,552421377,253228246,118113,448993,101467,215432511,127349,145848,93688756,199298
2/13/2022,N/A,US,Admin,USA,United States,76.3,64.9,43.5,552573039,151662,43989,552573039,253272235,115667,440409,45687,215478198,125294,60312,93749068,195141
2/14/2022,N/A,US,Admin,USA,United States,76.3,64.9,43.6,552909409,336370,89565,552909409,253361800,109824,420383,96221,215574419,120336,145951,93895019,185901
2/15/2022,N/A,US,Admin,USA,United States,76.3,65,43.6,553304907,395498,101415,553304907,253463215,106105,406321,114167,215688586,116037,174275,94069294,179772
2/16/2022,N/A,US,Admin,USA,United States,76.4,65,43.7,553711401,406494,103682,553711401,253566897,102124,392514,115221,215803807,111916,181977,94251271,173903
2/17/2022,N/A,US,Admin,USA,United States,76.4,65,43.7,554111377,399976,100410,554111377,253667307,97955,378240,108087,215911894,107573,184663,94435934,167882
2/18/2022,N/A,US,Admin,USA,United States,76.4,65.1,43.8,554630406,519029,127141,554630406,253794448,94145,364624,140721,216052615,103082,242513,94678447,162220
2/19/2022,N/A,US,Admin,USA,United States,76.5,65.1,43.9,554910660,280254,76918,554910660,253871366,91874,355612,77451,216130066,99651,122370,94800817,158866
2/20/2022,N/A,US,Admin,USA,United States,76.5,65.1,43.9,555063309,152649,43643,555063309,253915009,91825,355753,41513,216171579,99054,65305,94866122,159579
2/21/2022,N/A,US,Admin,USA,United States,76.5,65.1,43.9,555377642,314333,82310,555377642,253997319,90788,352605,86975,216258554,97734,138520,95004642,158518
2/22/2022,N/A,US,Admin,USA,United States,76.5,65.2,44,555718800,341158,89449,555718800,254086768,89079,344842,94574,216353128,94935,150014,95154656,155052
2/23/2022,N/A,US,Admin,USA,United States,76.6,65.2,44,556054946,336146,88361,556054946,254175129,86890,334792,90796,216443924,91445,150326,95304982,150530
2/24/2022,N/A,US,Admin,USA,United States,76.6,65.2,44.1,556377578,322632,84266,556377578,254259395,84584,323743,83484,216527408,87931,147808,95452790,145265
2/25/2022,N/A,US,Admin,USA,United States,76.6,65.2,44.1,556764261,386683,98398,556764261,254357793,80478,304836,102669,216630077,82495,177703,95630493,136007
2/26/2022,N/A,US,Admin,USA,United States,76.6,65.3,44.2,557005545,241284,67567,557005545,254425360,79142,299269,63521,216693598,80505,106865,95737358,133792
2/27/2022,N/A,US,Admin,USA,United States,76.6,65.3,44.2,557127880,122335,35450,557127880,254460810,77972,294939,31455,216725053,79068,53741,95791099,132140
2/28/2022,N/A,US,Admin,USA,United States,76.7,65.3,44.3,557437595,309715,79212,557437595,254540022,77529,294279,78755,216803808,77893,144954,95936053,133059
3/1/2022,N/A,US,Admin,USA,United States,76.7,65.3,44.3,557706553,268958,70364,557706553,254610386,74803,283965,71028,216874836,74530,120730,96056783,128875
3/2/2022,N/A,US,Admin,USA,United States,76.7,65.3,44.3,557959245,252692,68226,557959245,254678612,71926,272043,69720,216944556,71519,108606,96165389,122915
3/3/2022,N/A,US,Admin,USA,United States,76.7,65.4,44.4,558208538,249293,66390,558208538,254745002,69372,261566,67520,217012076,69238,109374,96274763,117425
3/4/2022,N/A,US,Admin,USA,United States,76.8,65.4,44.4,558521266,312728,80745,558521266,254825747,66851,251001,86455,217098531,66922,137678,96412441,111707
3/5/2022,N/A,US,Admin,USA,United States,76.8,65.4,44.4,558700489,179223,51096,558700489,254876843,64498,242135,50521,217149052,65065,75233,96487674,107188
3/6/2022,N/A,US,Admin,USA,United States,76.8,65.4,44.4,558788193,87704,27343,558788193,254904186,63339,237188,23946,217172998,63992,35299,96522973,104553
3/7/2022,N/A,US,Admin,USA,United States,76.8,65.4,44.5,558995095,206902,57998,558995095,254962184,60309,222500,53344,217226342,60362,90561,96613534,96783
3/8/2022,N/A,US,Admin,USA,United States,76.8,65.4,44.5,559206237,211142,56063,559206237,255018247,58266,214241,57373,217283715,58411,92146,96705680,92700
3/9/2022,N/A,US,Admin,USA,United States,76.8,65.5,44.5,559414737,208500,56430,559414737,255074677,56581,207927,57684,217341399,56692,89179,96794859,89924
3/10/2022,N/A,US,Admin,USA,United States,76.8,65.5,44.6,559623312,208575,55322,559623312,255129999,55000,202111,57752,217399151,55296,90494,96885353,87227
3/11/2022,N/A,US,Admin,USA,United States,76.9,65.5,44.6,559877370,254058,65247,559877370,255195246,52786,193729,72048,217471199,53238,110268,96995621,83311
3/12/2022,N/A,US,Admin,USA,United States,76.9,65.5,44.6,560017298,139928,39985,560017298,255235231,51198,188116,40370,217511569,51788,57569,97053190,80788
3/13/2022,N/A,US,Admin,USA,United States,76.9,65.5,44.6,560090539,73241,22262,560090539,255257493,50472,186049,20454,217532023,51289,29451,97082641,79953
3/14/2022,N/A,US,Admin,USA,United States,76.9,65.5,44.7,560281548,191009,51827,560281548,255309320,49591,183779,50028,217582051,50816,83088,97165729,78885
3/15/2022,N/A,US,Admin,USA,United States,76.9,65.6,44.7,560481034,199486,53207,560481034,255362527,49183,182114,51451,217633502,49970,87191,97252920,78177
3/16/2022,N/A,US,Admin,USA,United States,76.9,65.6,44.7,560683132,202098,54113,560683132,255416640,48852,181199,50965,217684467,49010,88450,97341370,78073
3/17/2022,N/A,US,Admin,USA,United States,76.9,65.6,44.7,560875349,192217,50181,560875349,255466821,48117,178862,46933,217731400,47464,86406,97427776,77489
3/18/2022,N/A,US,Admin,USA,United States,77,65.6,44.8,561123598,248249,64130,561123598,255530951,47958,178033,60247,217791647,45778,111893,97539669,77721
3/19/2022,N/A,US,Admin,USA,United States,77,65.6,44.8,561266871,143273,39999,561266871,255570950,47960,178510,36158,217827805,45177,61276,97600945,78251
3/20/2022,N/A,US,Admin,USA,United States,77,65.6,44.8,561341404,74533,23011,561341404,255593961,48067,178695,17494,217845299,44754,30882,97631827,78455
3/21/2022,N/A,US,Admin,USA,United States,77,65.6,44.8,561524380,182976,52045,561524380,255646006,48098,177547,42476,217887775,43675,78330,97710157,77775
3/22/2022,N/A,US,Admin,USA,United States,77,65.6,44.9,561700904,176524,47533,561700904,255693539,47287,174267,41891,217929666,42309,77235,97787392,76353
3/23/2022,N/A,US,Admin,USA,United States,77,65.7,44.9,561888112,187208,52622,561888112,255746161,47074,172140,44417,217974083,41374,80607,97867999,75233
3/24/2022,N/A,US,Admin,USA,United States,77,65.7,44.9,562071301,183189,53085,562071301,255799246,47489,170850,41568,218015651,40607,79049,97947048,74182
3/25/2022,N/A,US,Admin,USA,United States,77.1,65.7,45,562297696,226395,62837,562297696,255862083,47305,167728,52888,218068539,39556,99483,98046531,72409
3/26/2022,N/A,US,Admin,USA,United States,77.1,65.7,45,562419229,121533,34486,562419229,255896569,46517,164623,29620,218098159,38622,52429,98098960,71145
3/27/2022,N/A,US,Admin,USA,United States,77.1,65.7,45,562482293,63064,18384,562482293,255914953,45856,162984,14578,218112737,38205,26654,98125614,70541
3/28/2022,N/A,US,Admin,USA,United States,77.1,65.7,45,562650298,168005,50665,562650298,255965618,45659,160845,36711,218149448,37382,69506,98195120,69280
3/29/2022,N/A,US,Admin,USA,United States,77.1,65.7,45,562841804,191506,46536,562841804,256012154,45516,162986,38937,218188385,36960,75951,98271071,69097
3/30/2022,N/A,US,Admin,USA,United States,77.1,65.7,45.1,563235427,393623,60994,563235427,256073148,46712,192474,56109,218244494,38630,97620,98368691,71527
3/31/2022,N/A,US,Admin,USA,United States,77.2,65.8,45.1,563776927,541500,75815,563776927,256148963,49960,243661,64026,218308520,41838,108491,98477182,75733
4/1/2022,N/A,US,Admin,USA,United States,77.2,65.8,45.1,564405283,628356,77490,564405283,256226453,52053,301084,76396,218384916,45197,123600,98600782,79179
4/2/2022,N/A,US,Admin,USA,United States,77.2,65.8,45.2,564737074,331791,45831,564737074,256272284,53674,331121,42819,218427735,47082,63101,98663883,80703
4/3/2022,N/A,US,Admin,USA,United States,77.2,65.8,45.2,564939058,201984,29051,564939058,256301335,55197,350966,25196,218452931,48599,35759,98699642,82004
4/4/2022,N/A,US,Admin,USA,United States,77.2,65.8,45.2,565472824,533766,69800,565472824,256371135,57931,403218,59664,218512595,51878,93063,98792705,85369
4/5/2022,N/A,US,Admin,USA,United States,77.2,65.8,45.2,566002582,529758,62633,566002582,256433768,60231,451540,59165,218571760,54768,92597,98885302,87747
4/6/2022,N/A,US,Admin,USA,United States,77.3,65.9,45.3,566554136,551554,64540,566554136,256498308,60737,474101,62235,218633995,55643,97192,98982494,87686
4/7/2022,N/A,US,Admin,USA,United States,77.3,65.9,45.3,567112156,558020,63642,567112156,256561950,58998,476461,60804,218694799,55183,97098,99079592,86059
4/8/2022,N/A,US,Admin,USA,United States,77.3,65.9,45.3,567755976,643820,71538,567755976,256633488,58148,478670,72114,218766913,54571,112903,99192495,84530
4/9/2022,N/A,US,Admin,USA,United States,77.3,65.9,45.4,568078764,322788,43679,568078764,256677167,57840,477384,40412,218807325,54227,57858,99250353,83781
4/10/2022,N/A,US,Admin,USA,United States,77.3,65.9,45.4,568266940,188176,27451,568266940,256704618,57612,475412,23829,218831154,54032,33170,99283523,83412
4/11/2022,N/A,US,Admin,USA,United States,77.3,65.9,45.4,568817878,550938,64979,568817878,256769597,56923,477865,58973,218890127,53933,92142,99375665,83280
4/12/2022,N/A,US,Admin,USA,United States,77.4,65.9,45.4,569401033,583155,66543,569401033,256836140,57482,485493,60105,218950232,54067,96626,99472291,83856
4/13/2022,N/A,US,Admin,USA,United States,77.4,66,45.5,569951472,550439,66443,569951472,256902583,57754,485334,59042,219009274,53611,93926,99566217,83389
4/14/2022,N/A,US,Admin,USA,United States,77.4,66,45.5,570508211,556739,66828,570508211,256969411,58209,485151,59126,219068400,53372,96350,99662567,83282
4/15/2022,N/A,US,Admin,USA,United States,77.4,66,45.5,571045622,537411,66279,571045622,257035690,57457,469949,61491,219129891,51854,97522,99760089,81085
4/16/2022,N/A,US,Admin,USA,United States,77.4,66,45.5,571293636,248014,36865,571293636,257072555,56484,459267,31559,219161450,50589,47586,99807675,79617
4/17/2022,N/A,US,Admin,USA,United States,77.4,66,45.5,571349971,56335,11923,571349971,257084478,54266,440433,7897,219169347,48313,10987,99818662,76448
4/18/2022,N/A,US,Admin,USA,United States,77.5,66,45.6,571836238,486267,58779,571836238,257143257,53380,431194,53786,219223133,47572,83698,99902360,75242
4/19/2022,N/A,US,Admin,USA,United States,77.5,66,45.6,572342104,505866,59619,572342104,257202876,52391,420153,53267,219276400,46595,85561,99987921,73661
4/20/2022,N/A,US,Admin,USA,United States,77.5,66.1,45.6,572830261,488157,57370,572830261,257260246,51095,411256,52939,219329339,45724,83822,100071743,72218
4/21/2022,N/A,US,Admin,USA,United States,77.5,66.1,45.7,573290400,460139,55238,573290400,257315484,49439,397456,50202,219379541,44449,80372,100152115,69935
4/22/2022,N/A,US,Admin,USA,United States,77.5,66.1,45.7,573730834,440434,50341,573730834,257365825,47162,383602,50291,219429832,42849,78142,100230257,67167
4/23/2022,N/A,US,Admin,USA,United States,77.5,66.1,45.7,573972861,242027,34667,573972861,257400492,46848,382746,30879,219460711,42752,46455,100276712,67005
4/24/2022,N/A,US,Admin,USA,United States,77.5,66.1,45.7,574095227,122366,19419,574095227,257419911,47919,392179,16375,219477086,43963,23695,100300407,68821
4/25/2022,N/A,US,Admin,USA,United States,77.5,66.1,45.7,574451381,356154,42816,574451381,257462727,45639,373592,40087,219517173,42006,61336,100361743,65626
4/26/2022,N/A,US,Admin,USA,United States,77.6,66.1,45.7,574706156,254775,30056,574706156,257492783,41415,337722,27846,219545019,38374,43451,100405194,59610
4/27/2022,N/A,US,Admin,USA,United States,77.6,66.1,45.7,574738978,32822,4069,574738978,257496852,33801,272674,5009,219550028,31527,5918,100411112,48481
